[layer1]
1 1 3 2 3 0
3 2 3 1 2 0
2 2 3 2 3 0
1 1 2 2 1 0

[layer2]
0 0 0 0 0 0
0 0 0 0 0 2
0 0 0 0 0 1
0 0 0 0 0 0